ekkaiaenoia	ekka
kar72	kar 
eruiskawaii	eru 
peeku	watashiiit	eric
smarthardyz	smart 
watashiii	watashi 	akl
bop	shake
poolnoodle	poolnoober
himemiya	himeiya
zeal_kido	zealkido
atsui	atsui_	cakey
shortcake	alice
bakeman	eggsdee
fumiii	vnsoul
ayroby	kar_4
falilv	gabrielarobin	spyair	milar
ilmatar	pantsudestroyer	kawasumiayako
shiinamahiru	yourslavesz
mahirushiina	yerardi
star_driver	stardriver
lilyholic	chelly
anonimus_opinion	anonimusopinion
szafa	chata
edwardd	edward 
konsumenci	konsu 
claydoll1091	claydoll 
renzou	ren 
zippy	stormross
poison205	hanato	yurinekurosawa
transfer	isischan
Anoru_	ksante4700hp	noru
vsai	sai
fortnayt	sewim
gyroinmobile	hitoribocchi
bella	bellaa	isabella	xieliann
gw13	x_____________
mitsorubi	mitsurobi
uomi	joey
ayamenakirium	monkeygangleader
753	fujimasakura	kezzy
kitasanblack	pleasety
wuffles	ailane	mekokicco
liljakatsuragi	asahinamafuyu	sanabanana
neptune	darkynep
mrwolf	mrwolf2
shadow	ichigohoshimiya
alicerin	lilypri
hmsuis	aimyon
zental	trustyouforever
spanky	grospoliner
tateyamaayano	tateyama_ayano 
inta	Chriskc2
baikinman	kiishua	kishua
AnnaYanami	Muenstier
Komari	mizukinana
nicole	NicoIe
keizan	Kenzou_Tenma